0

# # # # # # # # # # # # # # #
# . . . . . . # . . . . . . #
# . # # . # . # . # . # # . #
# . # # . # . # . # . # # . #
# . . . . . . . . . . . . . #
# . # . # . # # # . # . # . #
# . . . # . . # . . # . . . #
# # # . # # . # . # # . # # #
# # # . # . . . . . # . # # #
. . . . . . # # # . . . . . .
# # # . # . . _ . . # . # # #
# # # . # . # # # . # . # # #
# . . . . . . # . . . . . . #
# . # # . # . # . # . # # . #
# . . # . . . . . . . # . . #
# # . # . # # # # # . # . # #
# . . . . . . # . . . . . . #
# . # # # # . # . # # # # . #
# . . . . . . . . . . . . . #
# # # # # # # # # # # # # # #