1

# # # # # # # # # # # # # # #
# . . . . . . . . . . . . . #
# . # # . # # # # # . # # . #
# . # . . # . . . # . . # . #
# . # . # # . # . # # . # . #
# . . . . . . # . . . . . . #
# # . # # # . # . # # # . # #
# . . . # . . # . . # . . . #
# . # . # . # # # . # . # . #
. . . . . . # # # . . . . . .
# # # . # . . _ . . # . # # #
# # # . # # # . # # # . # # #
# # # . . . . . . . . . # # #
# . . . # . # . # . # . . . #
# . # # # . # . # . # # # . #
# . # . . . # . # . . . # . #
# . # . # # # . # # # . # . #
# . # . . . . . . . . . # . #
# . . . # # # # # # # . . . #
# # # # # # # # # # # # # # #