2

# # # # # # # # # # # # # # #
# . . . . . . # . . . . . . #
# . # # # # . # . # # # # . #
# . # . . . . . . . . . # . #
# . . . # . # # # . # . . . #
# # # . # . # # # . # . # # #
# . . . # . . . . . # . . . #
# . # . # # # . # # # . # . #
# . # . . . . . . . . . # . #
. . # # # . # # # . # # # . .
# . . . . . . _ . . . . . . #
# . # . # # # . # # # . # . #
# . # . . . . . . . . . # . #
# . # # # . # # # . # # # . #
# . . . . . . . . . . . . . #
# # . # . # # # # # . # . # #
# . . # . . . # . . . # . . #
# . # # . # . # . # . # # . #
# . . . . . . . . . . . . . #
# # # # # # # # # # # # # # #