3

# # # # # # # # # # # # # # #
# . . . # . . . . . # . . . #
# . # . # . # # # . # . # . #
# . # . . . . # . . . . # . #
# . # # . # . # . # . # # . #
# . . . . # . . . # . . . . #
# . # # . # # # # # . # # . #
# . . # . . . . . . . # . . #
# # . # . # # # # # . # . # #
. . . . . # # # # # . . . . .
# # . # . . . _ . . . # . # #
# . . # . # # # # # . # . . #
# . # # . # # # # # . # # . #
# . . . . . . . . . . . . . #
# # . # # # # . # # # # . # #
# # . . . # . . . # . . . # #
# . . # . # . # . # . # . . #
# . # # . . . . . . . # # . #
# . . . . # # # # # . . . . #
# # # # # # # # # # # # # # #